_X___X_X__
_S_X_X_X__
_XXX_X____
XX_____X__
____X__XXX
__XXXX__XE
______X_XX
_____X____
_____X____
_____X____